xxxxxxxxxxxxxxxxxxxxxxxxxxxxxxxxxxxxxxxxxx
x0000000000000000000000000000000x00000000x
x000x000000000000z00000000000000000000000x
x000x000000000000000000000000000x00000000x
x00000xxxx000000000000000000000000x000000x
x00000000000000xxxx00xxx000000000x0000000x
x00000x00000000000000000000000000x0000000x
x00000x0000000000000000000000000000000000x
x00x0000xxxx000000000000000xxxx0000000000x
x0000000000000000000000000000000000000000x
x0000000000000xxxxxxx00000000000000000000x
x0000000000000000000000000000000000xx0000x
x00000xxxx0000000000000000000000000000000x
x0000000000000000000000000000000000000000x
x00xxx00000000000000000x00000000000000000x
x0000000000000000000000000000xxxxxxxxxxxxx
x00000000000000000000000000000000x0000000x
x0000xxxxxxxxx0000000000000000000x0000000x
x000000000000000000x0000000000000x0000000x
xxxxxxxxxxx000000000000000000000000000000x
x000000000000000000000000000xxxxx00000000x
x0000000000000000000000000000000000000000x
x0000000000000000000000000000000000000000x
x00000000xxxxxxxx000000000000000000000000x
x0000000000000000000000000000000000000000x
x000000000000000000000xxxxxxxxxxx00000000x
x0000000000000000000000000000000000000000x
x00000xxxxxxxxxxxxxxxxxxxxxxxxxxxxxxxxxxxx
x00000x0000000000000000000000000000000000x
x00000x00x0000000000000000000000000000000x
x00000x00x0000000000000000000000000000000x
x00000x00x0000000000000000000000000000000x
x00000x000000000000000000x000000000000000x
x000000000000000000000000x000000000000000x
x0xxxxxxxxxxxxx000xxxxxxxxxxxxxxxxxxxxxxxx
x0000000000000000000000000000000000000000x
x0000000000000000000000000000000000000000x
x00000000000xxxxxx00000000000000000000000x
x0000000000000000000000000000000000000000x
x00000xx0000000000000000000xx000000000000x
x0000000000000000000000000000000000000000x
xxxxxxxxxxxxxxxxxxxxxxxxxxxxxxxxxxxxxxxxxx
