xxxxxxxxxxxxxxxxxxxxxxxxxxxxxxxxxxxxxxxxxx
x0000000000000000000000000000000000000000x
x0000000000000000000000000000000000000000x
x0z00000000000000000000000000000000000000x
x0000000000000000000000000000000000000000x
x0000000000000000000000000000000000000000x
x0000000000000000000000000000000000000000x
x0000000000000000000000000000000000000000x
x0000000000000000000000000000000000000000x
x0000000000000000000000000000000000000000x
x0000000000000000000000000000000000000000x
x0000000000000000000000000000000000000000x
x0000000000000000000000000000000000000000x
x0000000000000000000000000000000000000000x
x0000000000000000000000000000000000000000x
x0000000000000000000000000000000000000000x
x0000000000000000000000000000000000000000x
x0000000000000000000000000000000000000000x
x0000000000000000000000000000000000000000x
x0000000000000000000000000000000000000000x
x0000000000000000000000000000000000000000x
x0000000000000000000000000000000000000000x
x0000000000000000000000000000000000000000x
x0000000000000000000000000000000000000000x
x0000000000000000000000000000000000000000x
x0000000000000000000000000000000000000000x
x0000000000000000000000000000000000000000x
x00000xxxxxxxxxxxxxxxxxxxxxxxxxxxxxxxxxxxx
x00000x0000000000000000000000000000000000x
x00000x00x0000000000000000000000000000000x
x00000x00x0000000000000000000000000000000x
x00000x00x0000000000000000000000000000000x
x00000x000000000000000000x000000000000000x
x000000000000000000000000x000000000000000x
x0xxxxxxxxxxxxxxxxxxxxxxxxxxxxxxxxxxxxxxxx
x0000000000000000000000000000000000000000x
x0000000000000000000000000000000000000000x
x0000000000000000000000000000000000000000x
x0000000000000000000000000000000000000000x
x0000000000000000000000000000000000000000x
x0000000000000000000000000000000000000000x
xxxxxxxxxxxxxxxxxxxxxxxxxxxxxxxxxxxxxxxxxx
