xxxxxxxxxxxxxxxxxxxxxx
x00000000000000000000x
x00000000000000000000x
x00000000000000000000x
x00000000000000000000x
x00000000000000000000x
x00000000000x00000000x
x00000000000000000000x
x00000000000000000000x
x00000000000000000000x
x00000000000000000000x
xxz000000000000000000x
x00000000000000000000x
x00000000000000000000x
x00000000000000000000x
x00000000000000000000x
x00000000000000000000x
x00000000000000000000x
x00000000000000000000x
x000000000x0000000000x
x00000000000000000000x
x00000000000000000000x
xxxxxxxxxxxxxxxxxxxxxx
