xxxxxxxxxxxxxxxxxxxx
x000000000000000000x
x000000000000000000x
x000000000x00000000x
x000000000000000000x
x000000000000000000x
x000000000000000000x
x000000000000000000x
xxz0000000000000000x
x000000000000000000x
x000000000000000000x
x000000000000000000x
x000000000000000000x
x000000000000000000x
x000000000000000000x
x000000000000000000x
x000000000x00000000x
x000000000000000000x
x000000000000000000x
xxxxxxxxxxxxxxxxxxxx
