xxxxxxxxxxxxxxxxxxxx
x000000000000000000x
x000000000000000000x
x000000000x00000000x
x000000000000000000x
x000000000000000000x
x000000000000000000x
x000000000000000000x
xx00000000z00000000x
x000000000000000000x
x000000000000000000x
x000000000000000000x
x000000000000000000x
x000000000000000000x
x000000000000000000x
x000000000000000000x
x000000000x00000000x
x000000000000000000x
x000000000000000000x
xxxxxxxxxxxxxxxxxxxx
